ene1023080000100001001515000001ship
ene1064074600100001001515000001ship
ene1039070700100001001515000001ship
ene1022074200100001001515000001ship
ene0432049700100001001020000001ship
ene0449047700100001001020000001ship
ene0459046600100001001020000001ship
ene0466045500100001001020000001ship
ene0471044700100001001020000001ship
ene0481043000100001001020000001ship
ene0486041800100001001020000001ship
ene0490040700100001001020000001ship
ene0492039700100001001020000001ship
ene0499038700100001001020000001ship
ene0503037300100001001020000001ship
ene0505035500100001001020000001ship
ene0506034200100001001020000001ship
ene0509032700100001001020000001ship
ene0509031200100001001020000001ship
ene0512029600100001001020000001ship
ene0512026800100001001020000001ship
ene0512026400100001001020000001ship
ene0512024500100001001020000001ship
ene0509022500100001001020000001ship
ene0508021300100001001020000001ship
ene0508020300100001001020000001ship
ene0508019200100001001020000001ship
ene0507017000100001001020000001ship
ene0500013900100001001020000001ship
ene0499012900100001001020000001ship
ene0976066200100001001020000001ship
ene0979065300100001001020000001ship
ene0997062700100001001020000001ship
ene1009061100100001001020000001ship
ene1017060000100001001020000001ship
ene1026058700100001001020000001ship
ene1042057200100001001020000001ship
ene1050055700100001001020000001ship
ene1062053900100001001020000001ship
ene1071051700100001001020000001ship
ene1093047100100001001020000001ship
ene1093046900100001001020000001ship
ene1103045600100001001020000001ship
ene1120044000100001001020000001ship
ene1130041500100001001020000001ship
ene1134039300100001001020000001ship
ene1137036700100001001020000001ship
ene1147034100100001001020000001ship
ene1150032400100001001020000001ship
ene1154030000100001001020000001ship
ene1155026700100001001020000001ship
ene1153022900100001001020000001ship
ene1156017900100001001020000001ship
ene1136016000100001001020000001ship
ene1111013700100001001020000001ship
ene1100012100100001001020000001ship
ene1072010500100001001020000001ship
ene1056008800100001001020000001ship
ene1665045702000001010000000001city
ene1608050401000001000501400001ship
ene1591046801000001000501400001ship
ene1598043501000001000501400001ship
ene1630041101000001000501400001ship
ene1690040701000001000501400001ship
ene1487048801000001000501400001ship
ene1500040601000001000501400001ship
ene1554031401000001000501400001ship
ene1423026901000001000501400001ship
ene1391035201000001000501400001ship
ene1333046801000001000501400001ship
ene1284056301000001000501400001ship
roc02550036000000000000000000000000
roc02780032000000000000000000000000
roc03250023000000000000000000000000
roc03780021000000000000000000000000
roc03000029000000000000000000000000
roc03550018000000000000000000000000
roc04010020000000000000000000000000
roc04280020000000000000000000000000
roc04620020000000000000000000000000
roc04960018000000000000000000000000
roc05370016000000000000000000000000
roc05190015000000000000000000000000
roc05650014000000000000000000000000
roc05930013000000000000000000000000
roc06290013000000000000000000000000
roc06760011000000000000000000000000
roc06600013000000000000000000000000
roc06870013000000000000000000000000
roc07220013000000000000000000000000
roc07400013000000000000000000000000
roc07700013000000000000000000000000
roc07990012000000000000000000000000
roc08210012000000000000000000000000
roc08530013000000000000000000000000
roc08870015000000000000000000000000
roc09180016000000000000000000000000
roc09920021000000000000000000000000
roc09380016000000000000000000000000
roc09700016000000000000000000000000
roc09750016000000000000000000000000
roc10050012000000000000000000000000
roc10170012000000000000000000000000
roc10350012000000000000000000000000
roc10700012000000000000000000000000
roc11010016000000000000000000000000
roc11300020000000000000000000000000
roc11600022000000000000000000000000
roc11860023000000000000000000000000
roc12120029000000000000000000000000
roc12320033000000000000000000000000
roc12580051000000000000000000000000
roc12810074000000000000000000000000
roc12990101000000000000000000000000
roc13170123000000000000000000000000
roc13400143000000000000000000000000
roc13600164000000000000000000000000
roc13830185000000000000000000000000
roc14060199000000000000000000000000
roc14260215000000000000000000000000
roc14530564000000000000000000000000
roc14760546000000000000000000000000
roc15070536000000000000000000000000
roc15380538000000000000000000000000
roc15670537000000000000000000000000
roc15940537000000000000000000000000
roc16250522000000000000000000000000
roc16530541000000000000000000000000
roc16790522000000000000000000000000
roc17070540000000000000000000000000
roc17330521000000000000000000000000
roc17500501000000000000000000000000
roc17630473000000000000000000000000
roc17590455000000000000000000000000
roc17490433000000000000000000000000
roc17380409000000000000000000000000
roc17320393000000000000000000000000
roc17190373000000000000000000000000
roc17070355000000000000000000000000
roc16960335000000000000000000000000
roc16890311000000000000000000000000
roc16700289000000000000000000000000
roc16510266000000000000000000000000
roc16310250000000000000000000000000
roc16090239000000000000000000000000
roc15770225000000000000000000000000
roc15440222000000000000000000000000
roc15120219000000000000000000000000
roc14790216000000000000000000000000
roc14520204000000000000000000000000
roc14300586000000000000000000000000
roc13890594000000000000000000000000
roc14030600000000000000000000000000
roc13500600000000000000000000000000
roc13690592000000000000000000000000
roc13270594000000000000000000000000
roc13000596000000000000000000000000
roc12760595000000000000000000000000
roc12420600000000000000000000000000
roc12150615000000000000000000000000
roc12300642000000000000000000000000
roc12500668000000000000000000000000
roc12690697000000000000000000000000
roc12820732000000000000000000000000
roc12830767000000000000000000000000
roc12690803000000000000000000000000
roc12400835000000000000000000000000
roc12130851000000000000000000000000
roc11830858000000000000000000000000
roc11580863000000000000000000000000
roc11380864000000000000000000000000
roc11010863000000000000000000000000
roc10770855000000000000000000000000
roc10480838000000000000000000000000
roc11190880000000000000000000000000
roc10220828000000000000000000000000
roc09890821000000000000000000000000
roc09600813000000000000000000000000
roc09310804000000000000000000000000
roc09110794000000000000000000000000
roc08910784000000000000000000000000
roc08560768000000000000000000000000
roc08170759000000000000000000000000
roc07910741000000000000000000000000
roc07630724000000000000000000000000
roc07440713000000000000000000000000
roc07250700000000000000000000000000
roc06930680000000000000000000000000
roc06620664000000000000000000000000
roc06870676000000000000000000000000
roc07250690000000000000000000000000
roc02390052000000000000000000000000
roc02040058000000000000000000000000
roc01750056000000000000000000000000
roc01470054000000000000000000000000
roc01210052000000000000000000000000
roc00920055000000000000000000000000
roc00610054000000000000000000000000
roc00360056000000000000000000000000
roc00130058000000000000000000000000
roc00150088000000000000000000000000
roc00200126000000000000000000000000
roc00240118000000000000000000000000
roc00250163000000000000000000000000
roc00270190000000000000000000000000
roc00380208000000000000000000000000
roc00290231000000000000000000000000
roc00390254000000000000000000000000
roc00430277000000000000000000000000
roc00400300000000000000000000000000
roc00350329000000000000000000000000
roc00470360000000000000000000000000
roc00530391000000000000000000000000
roc00670422000000000000000000000000
roc00670447000000000000000000000000
roc00860489000000000000000000000000
roc00910514000000000000000000000000
roc01200547000000000000000000000000
roc00820481000000000000000000000000
roc00850468000000000000000000000000
roc01140538000000000000000000000000
roc01500566000000000000000000000000
roc01710594000000000000000000000000
roc01820600000000000000000000000000
roc02110621000000000000000000000000
roc02390626000000000000000000000000
roc02770635000000000000000000000000
roc03100636000000000000000000000000
roc03430642000000000000000000000000
roc03820643000000000000000000000000
roc04020646000000000000000000000000
roc04270650000000000000000000000000
roc04570650000000000000000000000000
roc04910652000000000000000000000000
roc05200654000000000000000000000000
roc05430654000000000000000000000000
roc05740659000000000000000000000000
roc06040661000000000000000000000000
roc06270663000000000000000000000000
roc06470665000000000000000000000000
roc06670343000000000000000000000000
roc07990489000000000000000000000000
roc07360550000000000000000000000000
roc06680450000000000000000000000000
roc08790319000000000000000000000000
roc08350188000000000000000000000000
roc07290166000000000000000000000000
roc09660516000000000000000000000000
roc08610680000000000000000000000000
roc10960273000000000000000000000000
roc09980148000000000000000000000000
roc10250338000000000000000000000000
roc04010132000000000000000000000000
roc03230302000000000000000000000000
roc03530466000000000000000000000000
roc02380390000000000000000000000000
roc02760222000000000000000000000000
roc04300341000000000000000000000000
roc06470228000000000000000000000000
roc13540410000000000000000000000000
roc13010514000000000000000000000000
roc02330133000000000000000000000000
roc02720140000000000000000000000000
roc03120141000000000000000000000000
roc03580138000000000000000000000000
roc04340112000000000000000000000000
roc04700101000000000000000000000000
roc05090096000000000000000000000000
roc05580096000000000000000000000000
roc06120099000000000000000000000000
roc06570110000000000000000000000000
roc05920103000000000000000000000000
roc02290428000000000000000000000000
roc02370468000000000000000000000000
roc02480510000000000000000000000000
roc02970523000000000000000000000000
roc03450530000000000000000000000000
roc03930534000000000000000000000000
roc04360538000000000000000000000000
roc04830537000000000000000000000000
roc05340532000000000000000000000000
