ene1560040102000003000303000010ship
ene1579038200080001010000000001city
ene1259056102000001010000000001city
ene0276013601000004000303000005ship
ene0296018501000004000303000005ship
ene0290024301000004000303000005ship
ene0234022001000004000303000005ship
ene0216019201000004000303000005ship
ene0185027201000004000303000005ship
ene0237031101000004000303000005ship
ene0294031301000004000303000005ship
ene0304036401000004000303000005ship
ene0248040101000004000303000005ship
ene0197039901000004000303000005ship
ene0182036701000004000303000005ship
ene0245036201000004000303000005ship
ene0299045001000004000303000005ship
ene0271046901000004000303000005ship
ene0232048601000004000303000005ship
ene0213049801000004000303000005ship
ene0206047701000004000303000005ship
ene0270045301000004000303000005ship
ene0330042301000004000303000005ship
ene0399039801000004000303000005ship
ene0419043201000004000303000005ship
ene0385047501000004000303000005ship
ene0336050101000004000303000005ship
ene0294052901000004000303000005ship
ene0264055501000004000303000005ship
ene0262058801000004000303000005ship
ene0269060601000004000303000005ship
ene0307061501000004000303000005ship
ene0355059801000004000303000005ship
ene0404058401000004000303000005ship
ene0443061601000004000303000005ship
ene0378066101000004000303000005ship
ene0318067101000004000303000005ship
ene0247065001000004000303000005ship
ene0216062501000004000303000005ship
ene0203058501000004000303000005ship
ene0505040001000004000303000005ship
ene0536037901000004000303000005ship
ene0553032401000004000303000005ship
ene0540025701000004000303000005ship
ene0495022601000004000303000005ship
ene0435021201000004000303000005ship
ene0399018901000004000303000005ship
ene0377015001000004000303000005ship
ene0385012801000004000303000005ship
ene0492010601000004000303000005ship
ene0588010701000004000303000005ship
ene0611015501000004000303000005ship
ene0544018401000004000303000005ship
ene0443014901000004000303000005ship
ene0421011001000004000303000005ship
ene0367009501000004000303000005ship
ene0337012101000004000303000005ship
ene0365019301000004000303000005ship
ene0378025501000004000303000005ship
ene0345028001000004000303000005ship
ene0663011501000004000303000005ship
ene0685009601000004000303000005ship
ene0706016101000004000303000005ship
ene0667021601000004000303000005ship
ene0635025601000004000303000005ship
ene0615031601000004000303000005ship
ene0615036501000004000303000005ship
ene0634041501000004000303000005ship
ene0687046701000004000303000005ship
ene0731051801000004000303000005ship
ene0730057601000004000303000005ship
ene0692063901000004000303000005ship
ene0641064701000004000303000005ship
ene0564066101000004000303000005ship
ene0526067601000004000303000005ship
ene0949036201000004000303000005ship
ene0974027701000004000303000005ship
ene0871024201000004000303000005ship
ene0818022601000004000303000005ship
ene0784020301000004000303000005ship
ene0769017801000004000303000005ship
ene0760011001000004000303000005ship
ene0761009001000004000303000005ship
ene0800007401000004000303000005ship
ene0897006501000004000303000005ship
ene0950006701000004000303000005ship
ene0998009001000004000303000005ship
ene1000013601000004000303000005ship
ene0943020701000004000303000005ship
ene0926030701000004000303000005ship
ene0892034601000004000303000005ship
ene0856030801000004000303000005ship
ene0809026401000004000303000005ship
ene0880026801000004000303000005ship
ene1045023901000004000303000005ship
ene1066014001000004000303000005ship
ene1090009601000004000303000005ship
ene1185010701000004000303000005ship
ene1206015201000004000303000005ship
ene1167022101000004000303000005ship
ene1083029001000004000303000005ship
ene1049036001000004000303000005ship
ene1077040801000004000303000005ship
ene1112043401000004000303000005ship
ene1141047401000004000303000005ship
ene1140052601000004000303000005ship
ene1125059301000004000303000005ship
ene1100062901000004000303000005ship
ene0996063701000004000303000005ship
ene0954058301000004000303000005ship
ene0949051601000004000303000005ship
ene0957045201000004000303000005ship
ene0877050001000004000303000005ship
ene0851055301000004000303000005ship
ene0840059701000004000303000005ship
ene0814061201000004000303000005ship
ene0924063301000004000303000005ship
ene0861066601000004000303000005ship
ene0807067301000004000303000005ship
ene0758067501000004000303000005ship
ene0724062101000004000303000005ship
ene0681059301000004000303000005ship
ene0650054201000004000303000005ship
ene0633048901000004000303000005ship
ene0609045801000004000303000005ship
ene0590043801000004000303000005ship
ene0570042401000004000303000005ship
ene0495044201000004000303000005ship
ene0475043901000004000303000005ship
ene0463039701000004000303000005ship
ene0473035701000004000303000005ship
ene0493032801000004000303000005ship
ene0504030301000004000303000005ship
ene0606024401000004000303000005ship
ene0625021401000004000303000005ship
ene0638019701000004000303000005ship
ene0503018401000004000303000005ship
ene0519016301000004000303000005ship
ene0536015001000004000303000005ship
ene0603019801000004000303000005ship
ene0591022201000004000303000005ship
ene0592028001000004000303000005ship
ene0907020101000004000303000005ship
ene0915019501000004000303000005ship
roc01090191000000000000000000000000
roc01030233000000000000000000000000
roc01060221000000000000000000000000
roc01050268000000000000000000000000
roc01150310000000000000000000000000
roc01120297000000000000000000000000
roc01180334000000000000000000000000
roc01220368000000000000000000000000
roc01250408000000000000000000000000
roc01330442000000000000000000000000
roc01200470000000000000000000000000
roc01250496000000000000000000000000
roc01260516000000000000000000000000
roc01310538000000000000000000000000
roc01300572000000000000000000000000
roc01110176000000000000000000000000
roc01210158000000000000000000000000
roc01270145000000000000000000000000
roc01340130000000000000000000000000
roc01430118000000000000000000000000
roc01530104000000000000000000000000
roc01670090000000000000000000000000
roc01910070000000000000000000000000
roc02100055000000000000000000000000
roc02350043000000000000000000000000
roc02550036000000000000000000000000
roc02780032000000000000000000000000
roc03250023000000000000000000000000
roc03780021000000000000000000000000
roc03000029000000000000000000000000
roc03550018000000000000000000000000
roc04010020000000000000000000000000
roc04280020000000000000000000000000
roc04620020000000000000000000000000
roc04960018000000000000000000000000
roc05370016000000000000000000000000
roc05190015000000000000000000000000
roc05650014000000000000000000000000
roc05930013000000000000000000000000
roc06290013000000000000000000000000
roc06760011000000000000000000000000
roc06600013000000000000000000000000
roc06870013000000000000000000000000
roc07220013000000000000000000000000
roc07400013000000000000000000000000
roc07700013000000000000000000000000
roc07990012000000000000000000000000
roc08210012000000000000000000000000
roc08530013000000000000000000000000
roc08870015000000000000000000000000
roc09180016000000000000000000000000
roc09920021000000000000000000000000
roc09380016000000000000000000000000
roc09700016000000000000000000000000
roc09750016000000000000000000000000
roc10050012000000000000000000000000
roc10170012000000000000000000000000
roc10350012000000000000000000000000
roc10700012000000000000000000000000
roc11010016000000000000000000000000
roc11300020000000000000000000000000
roc11600022000000000000000000000000
roc11860023000000000000000000000000
roc12120029000000000000000000000000
roc12320033000000000000000000000000
roc01240393000000000000000000000000
roc01240442000000000000000000000000
roc01350597000000000000000000000000
roc01450623000000000000000000000000
roc01500632000000000000000000000000
roc01620654000000000000000000000000
roc01700667000000000000000000000000
roc01780680000000000000000000000000
roc02050689000000000000000000000000
roc02280693000000000000000000000000
roc02490695000000000000000000000000
roc02700698000000000000000000000000
roc02910710000000000000000000000000
roc02980712000000000000000000000000
roc03280715000000000000000000000000
roc03450721000000000000000000000000
roc03510725000000000000000000000000
roc03820728000000000000000000000000
roc03900730000000000000000000000000
roc04010733000000000000000000000000
roc04310739000000000000000000000000
roc04590740000000000000000000000000
roc04790743000000000000000000000000
roc05120746000000000000000000000000
roc05220747000000000000000000000000
roc05570747000000000000000000000000
roc05660747000000000000000000000000
roc06040747000000000000000000000000
roc06250747000000000000000000000000
roc05910749000000000000000000000000
roc06590744000000000000000000000000
roc06860745000000000000000000000000
roc07090748000000000000000000000000
roc07290748000000000000000000000000
roc07590748000000000000000000000000
roc07750748000000000000000000000000
roc08030747000000000000000000000000
roc08310747000000000000000000000000
roc08710744000000000000000000000000
roc09100744000000000000000000000000
roc08540744000000000000000000000000
roc08880734000000000000000000000000
roc09430743000000000000000000000000
roc09730744000000000000000000000000
roc09880744000000000000000000000000
roc10170744000000000000000000000000
roc10430744000000000000000000000000
roc10760744000000000000000000000000
roc11030744000000000000000000000000
roc11310744000000000000000000000000
roc11600744000000000000000000000000
roc11860744000000000000000000000000
roc12060740000000000000000000000000
roc12180730000000000000000000000000
roc12340719000000000000000000000000
roc12470703000000000000000000000000
roc12610688000000000000000000000000
roc12720674000000000000000000000000
roc12810659000000000000000000000000
roc12860648000000000000000000000000
roc12580051000000000000000000000000
roc12810074000000000000000000000000
roc12990101000000000000000000000000
roc13170123000000000000000000000000
roc13400143000000000000000000000000
roc13600164000000000000000000000000
roc13830185000000000000000000000000
roc14060199000000000000000000000000
roc14260215000000000000000000000000
roc13020640000000000000000000000000
roc13210626000000000000000000000000
roc13470623000000000000000000000000
roc13710609000000000000000000000000
roc13980596000000000000000000000000
roc14240579000000000000000000000000
roc14530564000000000000000000000000
roc14760546000000000000000000000000
roc15070536000000000000000000000000
roc15380538000000000000000000000000
roc15670537000000000000000000000000
roc15940537000000000000000000000000
roc16250522000000000000000000000000
roc16530541000000000000000000000000
roc16790522000000000000000000000000
roc17070540000000000000000000000000
roc17330521000000000000000000000000
roc17500501000000000000000000000000
roc17630473000000000000000000000000
roc17590455000000000000000000000000
roc17490433000000000000000000000000
roc17380409000000000000000000000000
roc17320393000000000000000000000000
roc17190373000000000000000000000000
roc17070355000000000000000000000000
roc16960335000000000000000000000000
roc16890311000000000000000000000000
roc16700289000000000000000000000000
roc16510266000000000000000000000000
roc16310250000000000000000000000000
roc16090239000000000000000000000000
roc15770225000000000000000000000000
roc15440222000000000000000000000000
roc15120219000000000000000000000000
roc14790216000000000000000000000000
roc14520204000000000000000000000000
roc12480451000000000000000000000000
roc12420432000000000000000000000000
roc12330409000000000000000000000000
roc12310388000000000000000000000000
roc12330364000000000000000000000000
roc12360338000000000000000000000000
roc12460317000000000000000000000000
roc12630295000000000000000000000000
roc12780271000000000000000000000000
roc12960245000000000000000000000000
roc07270250000000000000000000000000
roc07480275000000000000000000000000
roc07690300000000000000000000000000
roc07890328000000000000000000000000
roc08090355000000000000000000000000
roc08290381000000000000000000000000
roc08510410000000000000000000000000
roc08550446000000000000000000000000
roc07080260000000000000000000000000
roc07010289000000000000000000000000
roc06960326000000000000000000000000
roc07060312000000000000000000000000
roc07120357000000000000000000000000
roc07330387000000000000000000000000
roc07490412000000000000000000000000
roc07720432000000000000000000000000
roc08010448000000000000000000000000
roc08250458000000000000000000000000
roc13170266000000000000000000000000
roc13340297000000000000000000000000
roc13390327000000000000000000000000
roc13480367000000000000000000000000
roc13570354000000000000000000000000
roc13520398000000000000000000000000
roc13500429000000000000000000000000
roc13320453000000000000000000000000
roc13110478000000000000000000000000
roc04940589000000000000000000000000
roc04820570000000000000000000000000
roc04740548000000000000000000000000
roc04710527000000000000000000000000
roc04740507000000000000000000000000
roc04870487000000000000000000000000
roc05100473000000000000000000000000
roc05370472000000000000000000000000
roc05670484000000000000000000000000
roc05900508000000000000000000000000
roc05940541000000000000000000000000
roc05800571000000000000000000000000
roc05540586000000000000000000000000
roc05320594000000000000000000000000
roc05090590000000000000000000000000
roc07510390000000000000000000000000
roc07950428000000000000000000000000
roc03880301000000000000000000000000
roc03950275000000000000000000000000
roc04300278000000000000000000000000
roc04300320000000000000000000000000
roc04130335000000000000000000000000
roc04120307000000000000000000000000
roc04480305000000000000000000000000
roc08280129000000000000000000000000
roc08270106000000000000000000000000
roc08430105000000000000000000000000
roc08680113000000000000000000000000
roc08710151000000000000000000000000
roc08490139000000000000000000000000
roc10070524000000000000000000000000
roc10320507000000000000000000000000
roc10630551000000000000000000000000
roc12740476000000000000000000000000
roc12900478000000000000000000000000
