ene1534036304000001010000000001city
ene1457050500100001001003000001ship
ene1452048200100001001003000001ship
ene1445046500100001001003000001ship
ene1441045100100001001003000001ship
ene1441043400100001001003000001ship
ene1441041800100001001003000001ship
ene1438039900100001001003000001ship
ene1439038100100001001003000001ship
ene1439036400100001001003000001ship
ene1442034500100001001003000001ship
ene1445032100100001001003000001ship
ene1449030800100001001003000001ship
ene1456028500100001001003000001ship
ene1461026700100001001003000001ship
ene1478025100100001001003000001ship
ene0304009600100001001003000001ship
ene0329012500100001001003000001ship
ene0347015500100001001003000001ship
ene0340018700100001001003000001ship
ene0285034000100001001003000001ship
ene0250036500100001001003000001ship
ene0217039400100001001003000001ship
ene0192042300100001001003000001ship
ene0655042700100001001003000001ship
ene0645039900100001001003000001ship
ene0642036400100001001003000001ship
ene0643033100100001001003000001ship
ene0868061800100001001003000001ship
ene0907058900100001001003000001ship
ene0925055000100001001003000001ship
ene0938051200100001001003000001ship
ene0507019500100001001003000001ship
ene0524015100100001001003000001ship
ene0538013500100001001003000001ship
ene0568011700100001001003000001ship
ene1009027604000001010000000001city
ene0975030100100001001001400001ship
ene0972028400100001001001400001ship
ene0971026900100001001001400001ship
ene0982025400100001001001400001ship
ene1004024400100001001001400001ship
ene1041024900100001001001400001ship
ene1029024300100001001001400001ship
ene1059026700100001001001400001ship
ene1053030000100001001001400001ship
ene1035031600100001001001400001ship
ene1009032700100001001001400001ship
ene0993032500100001001001400001ship
roc08530013000000000000000000000000
roc08870015000000000000000000000000
roc10700012000000000000000000000000
roc11010016000000000000000000000000
roc11300020000000000000000000000000
roc11600022000000000000000000000000
roc11860023000000000000000000000000
roc12810074000000000000000000000000
roc12990101000000000000000000000000
roc13170123000000000000000000000000
roc13400143000000000000000000000000
roc13600164000000000000000000000000
roc13830185000000000000000000000000
roc14060199000000000000000000000000
roc14260215000000000000000000000000
roc14520204000000000000000000000000
roc07690300000000000000000000000000
roc07890328000000000000000000000000
roc08510410000000000000000000000000
roc13340297000000000000000000000000
roc13320453000000000000000000000000
roc05670484000000000000000000000000
roc05900508000000000000000000000000
roc10070524000000000000000000000000
roc10320507000000000000000000000000
roc10630551000000000000000000000000
roc01520107000000000000000000000000
roc01710085000000000000000000000000
roc01880062000000000000000000000000
roc02280055000000000000000000000000
roc02100046000000000000000000000000
roc02640047000000000000000000000000
roc02930039000000000000000000000000
roc03230039000000000000000000000000
roc03530035000000000000000000000000
roc03790031000000000000000000000000
roc04060023000000000000000000000000
roc04310020000000000000000000000000
roc04580018000000000000000000000000
roc04860017000000000000000000000000
roc05160014000000000000000000000000
roc05440014000000000000000000000000
roc05700014000000000000000000000000
roc05980015000000000000000000000000
roc06270013000000000000000000000000
roc06510009000000000000000000000000
roc06790011000000000000000000000000
roc07080013000000000000000000000000
roc07380014000000000000000000000000
roc07660022000000000000000000000000
roc01310325000000000000000000000000
roc01360355000000000000000000000000
roc01370383000000000000000000000000
roc01370414000000000000000000000000
roc01400444000000000000000000000000
roc01420477000000000000000000000000
roc01470505000000000000000000000000
roc01570535000000000000000000000000
roc01650565000000000000000000000000
roc01760596000000000000000000000000
roc01850629000000000000000000000000
roc01990658000000000000000000000000
roc02210678000000000000000000000000
roc02460692000000000000000000000000
roc02720693000000000000000000000000
roc02990693000000000000000000000000
roc03310694000000000000000000000000
roc03590697000000000000000000000000
roc03890698000000000000000000000000
roc04170697000000000000000000000000
roc04450697000000000000000000000000
roc04730696000000000000000000000000
roc05010693000000000000000000000000
roc05260693000000000000000000000000
roc05540690000000000000000000000000
roc05810694000000000000000000000000
roc06090693000000000000000000000000
roc06380689000000000000000000000000
roc06650690000000000000000000000000
roc06920688000000000000000000000000
roc07210688000000000000000000000000
roc07470691000000000000000000000000
roc07740694000000000000000000000000
roc07990692000000000000000000000000
roc08280695000000000000000000000000
roc08570694000000000000000000000000
roc08910690000000000000000000000000
roc09200690000000000000000000000000
roc09480690000000000000000000000000
roc09740687000000000000000000000000
roc10030686000000000000000000000000
roc10290686000000000000000000000000
roc10590685000000000000000000000000
roc10850683000000000000000000000000
roc11120682000000000000000000000000
roc11380682000000000000000000000000
roc11630681000000000000000000000000
roc11900678000000000000000000000000
roc12210675000000000000000000000000
roc12500670000000000000000000000000
roc12790663000000000000000000000000
roc13060652000000000000000000000000
roc13300638000000000000000000000000
roc13510623000000000000000000000000
roc13760608000000000000000000000000
roc13990595000000000000000000000000
roc14280585000000000000000000000000
roc14530570000000000000000000000000
roc14820558000000000000000000000000
roc15120544000000000000000000000000
roc15220526000000000000000000000000
roc15350498000000000000000000000000
roc15440475000000000000000000000000
roc15520451000000000000000000000000
roc15760438000000000000000000000000
roc16070422000000000000000000000000
roc16180402000000000000000000000000
roc16270369000000000000000000000000
roc14800209000000000000000000000000
roc15060220000000000000000000000000
roc15350229000000000000000000000000
roc15630242000000000000000000000000
roc15910259000000000000000000000000
roc16180282000000000000000000000000
roc16350313000000000000000000000000
roc16510349000000000000000000000000
roc12150027000000000000000000000000
roc12440029000000000000000000000000
roc12710043000000000000000000000000
roc07900016000000000000000000000000
roc08170015000000000000000000000000
roc08380036000000000000000000000000
roc09150008000000000000000000000000
roc09400006000000000000000000000000
roc09640000000000000000000000000000
roc03160246000000000000000000000000
roc03460231000000000000000000000000
roc03560272000000000000000000000000
roc03890252000000000000000000000000
roc03980221000000000000000000000000
roc03710207000000000000000000000000
roc07350129000000000000000000000000
roc07640132000000000000000000000000
roc07920127000000000000000000000000
roc08220119000000000000000000000000
roc08520110000000000000000000000000
roc08840131000000000000000000000000
roc06710099000000000000000000000000
roc05640217000000000000000000000000
roc03030399000000000000000000000000
roc04770375000000000000000000000000
roc05270479000000000000000000000000
roc04890476000000000000000000000000
roc05020521000000000000000000000000
roc05470527000000000000000000000000
roc05980579000000000000000000000000
roc05580573000000000000000000000000
roc05200567000000000000000000000000
roc04750563000000000000000000000000
roc06100546000000000000000000000000
roc06670587000000000000000000000000
roc07630591000000000000000000000000
roc04610532000000000000000000000000
roc04200495000000000000000000000000
roc03620472000000000000000000000000
roc07360327000000000000000000000000
roc07440377000000000000000000000000
roc07380428000000000000000000000000
roc07950410000000000000000000000000
roc13090327000000000000000000000000
roc12870359000000000000000000000000
roc12810406000000000000000000000000
roc13210393000000000000000000000000
roc13360367000000000000000000000000
roc13610337000000000000000000000000
roc13630406000000000000000000000000
roc13140440000000000000000000000000
roc12640465000000000000000000000000
roc12420435000000000000000000000000
roc09990011000000000000000000000000
roc09950005000000000000000000000000
roc10270012000000000000000000000000
roc10470016000000000000000000000000
roc01180307000000000000000000000000
roc00880292000000000000000000000000
roc00600273000000000000000000000000
roc00440244000000000000000000000000
roc00340216000000000000000000000000
roc00330190000000000000000000000000
roc00390164000000000000000000000000
roc00540149000000000000000000000000
roc00820136000000000000000000000000
roc01130126000000000000000000000000
roc01460135000000000000000000000000
roc06530555000000000000000000000000
roc04570478000000000000000000000000
roc08210368000000000000000000000000
roc04150465000000000000000000000000
roc01040418000000000000000000000000
roc00790418000000000000000000000000
roc00320418000000000000000000000000
roc00180418000000000000000000000000
roc00060158000000000000000000000000
roc00530107000000000000000000000000
roc00570063000000000000000000000000
roc00590051000000000000000000000000
roc00580025000000000000000000000000
roc00550002000000000000000000000000
roc00460006000000000000000000000000
